
1111111111111111111111111111111111111111111111111111111111111111111111111111111111111111111111111111
1111111111111111001111111111111111111111111000011111111111111110011111111111111111111111111111111111
1111111111111110000111111111111111111110000000001111100000000000001111111111111111111111111111111111
1111111111111110000000011111111111111100000000001111000000000000000111111111111111111111111111111111
1111111111111110000000001111100111111000000000001111000000000000000011111111110011111111111111111111
1111111111111100000000000111000011111000000000001111000000000111100000111111100001111111111111111111
1111111111111000000000000000000011111000011111011111100000001111110000011111000000111111110011111111
1111111111100000000000000000000011111000111111111111111000011111111000011111000000011111100001111111
1111111111000000000000000000000111111001111111111111111100011111111100001111000000000111100001111111
1111111110000000000001110000001111111001111111111111111100001111111111000110000000000011110000111111
1111111110000000000011111000011111111001111111111111111110011111111111100000001100000011111000000011
1111111110000000011111111000011111111001111111111111111111111111111111110000011110000011111000000001
1111100111000000111111111000011111111001111111111111111111111111111111110000011110000001110000000001
1111000011100001111111110000011111110011111111111111111111111111111111000000111111000000000000000011
1111000011110001111110000000001110000111111111111111111111111111111110000000111111100000000000000011
1111000011110011111100000000000000001111111111111111111111111111111110000000011111100000000000000011
1111100001100011111110000000000000111111111111111111111111111111111110000000000011000000000111100111
1111110000000011111111110000000001111111111111111111111111111111111111000000000000000000001111111111
1111110000000111111111111100000001111111111111111111111111001111111111100000000000000000011111111111
1111100000111111111111111110000011111111111111011111111110000111111111111110000000000000011111111111
1111000001111111111111111111000011111111111110001111111100000011111111111111000000000000011111111111
1110000111111111111111111111000001111111110000000111110000000001111111111111000000000000011111111111
1110001111111111111111111111000000011111100000000111100000000001111111111111100000000000011111111111
1111111111001111111111111110000000001111100000001111100000000011111111111111100000000000011111111111
1111111110000001111111110000000000000111110000011111100000000011111111111111110000000000011111111111
1111111100000000111111100000000000000011111000011111100000000001111111111111111000000000011111111111
1111111100000000011111000000000000000001111000011111000000000000111111111100111100000000001111100111
1111111100000000011100000000000000000000111100001110000000000000011111111000011100000000000000000011
1111111110000000111000000000000000000000111100000000000000000000011111111000000000000000000000000011
1111111110000001111000000000000000000000011000000000000000000000111111111000000000000000000000000111
1111111100000001111000000000000000000000000000000000000000000001111111110000000000000000000000001111
1111100000000000110000000000001110000000000000000110000000000011111111100000000000000000011100011111
1111000000110000000000000000011111000011100000001111000000000011111111100000000000000000111111111111
1111000001111000000000000000111111100111110000001111100000000011111111110000000000000000111111111111
1111000011111000000000000000111111111111110000000111100000000001111111111100000000000000111111111111
1110000011110000000000000000011111111111110000000011000000000001111111111110000000000000011111111111
1100000011110000000000000000000011111111110000000000000000000000111111111110000000000000011111111111
1100000111111000000000000000000001111111110000000000000000110000111100001100000000000000111111111111
1100000111111100000000000000000001111111100000000000000001111000111000000000000000000111111111111111
1100001111111100000000000110000001111111000000001111000001111000011000000000000000001111111111111111
1100001111111100000000001111000011111100000000011111100011111100011000000000000000001111111111111111
1100000111111000000000001111100111111000000000011111111111111100011100000000000000011111111111111111
1110000000000000000000011111111111110000110000011111111111111100001110000000000000111111111111111111
1110000000000000000011111111111111100001111000011111111111111100000111111100000000111111111111111111
1100000000000000000111111111111111100001111100111111111110011100000011111110000000111111111111111111
1100000000000000000111111111111111110001111111111111111100001110000001111110000000111111111111111111
1100000000001110000011111111111111110001111111111111111000001111000000011110000000011111111111111111
1110000000011111000011111111111111100011111111111111110000001111000000001110000000000001110011111111
1110000000011111100111111111111111100111111111111111100000000111100000000110000000000000000001111111
1110000000001111111111111111111111100111111111111110000000000011110000000000000000000000000001111111
1100000000000111111111111111111111000111111111111100000000000011111000000000000000110000000001111111
1100000000000000011111111111111110000011111111111100000000000001111100000000000111111000110001111111
1100000000000000000111111111111110000011111111111100000000000000111100000000001111111111111000111111
1100000000000011100001100011111110000011111111111100000000000000011000000000011111111111111000011111
1100000000000111110000000001111110000011111111111100000000000000000000000011111111111111111000001111
1000000000001111111000000000111111000111111111111100000000000110000000011111111111111111110000001111
1000000000011111111100000000111111111111111111111110000110001111000000111111111111111111110000011111
1100111000111111111111000001111111111111111111111111111111111111100001111111111111111111111000111111
1111111111111111111111111111111111111111111111111111111111111111111111111111111111111111111111111111
1111111111111111111111111111111111111111111111111111111111111111111111111111111111111111111111111111