
1111111111111111111111111111111111111111111111111111111111111111111111111111111111111111111111111111
1111111111111111111111111111111111111111111110000000000111111111111111111111111111111111111111111111
1111111111111111111111111111111111111111100000000000000111111111111110011111111111111111111111111111
1111111111111111111111111111111111111111000000001111100001111111111100001111011111111111111111111111
1111110001111111111111111111111111111111000000111111111001111111111100000000011111111111111100111111
1111110001111111111111111111111111111111000011111111111111111111111100000000011111111111111100111111
1111110001111111111111111111111111101110000111111111111111111111111000111000001111111111111110011111
1111100001111111111111111111111111000110000111111111110001111111110001111100001111111111111000011111
1111000000111111111111111111111111000110000011000111110001111110000001111000001111111111100000011111
1110000000000111111111111111111111000110000000000011110001111000001111110000011111111111000000111111
1100000000000111111011111110011100000111000000000011111011110000011111100000011111111110001111111111
1110000000000111000001110000000000000111110000000111110001110000011111100000011111111110000111111011
1111111100000110000000000000000000000111111000000111111000110000011111100000011111111100000011000001
1111111100000000000000000000110000000011111111000011111000111000111111000000111111111000000000000001
1111100000000000000000000111111000000011111111100000000000111100111111000000111001110000000000000011
1111000000000000001110000111110000000011111111100000000001111100111110000000010000000000000001111111
1110000000111000011111001111100000001111111111100100000011111000010000000000000000000000000011111111
1110000001111100111111111110000000011111111111111100000111111000000000000000000000000000000111111111
1111000001111100111111111100000000111111111111111100000111111000000000000000000011000111111111111111
1111100001111111111111111001110001111111111111111110000011111100000000000000000111101111111111111111
1111110011111111110000110011110011111111111111111111000000011110000000000000000111111111111111111111
1111111111111111100000000111111111111111111100001111000000011111110000000000000111111111111111111111
1111111111111111000000000111111111111111111100000011000000111111111000000000001111111111000111111111
1111111111111110000000001111111111100111111100000001000001111111111100000000000111111110000011111111
1111001111111100000000001111111111000011110000000000000001111111111000000000000111111100010000111111
1110000111111100000000001111111111000001100000000000000001111111110000000000000111110000111000111111
1110000011111000000000011111100000000000000000000000000001111001100000000000000111110001110000111111
1110000001110000000000111111000000001100000000000000000000110001100000000000000111111111110001111111
1100000000110000000001111111111000011110000000000000000000000001111100000000001111111111110001111111
1100000000011001100000111111111000011110000000000000000000000001111110000000001111111111110000001111
1000000000001111100000011111111000111110000000000000000000000011111111000111111111111111100000000011
1000000111001111000000001111000001111110000000000000000000001111111111001111111111110000000000000011
1100001111101111000110001100000001111110000110000000011110011111111111001111111111100000001111100011
1100001111111110000110001000000000111100001111000000111111111111000000001111111000000000011111110011
1100001111111110000110000000110000011100001111000001111111111111000000001111110000000000111111111011
1100001111111110001110000001111000011110000111000001111111111110000000011111100000000001111111111001
1100011111111110001110001111111110011111000111000000011111111100000000011111100000000011111111111001
1100011111111100011110001111111111001111111111000000001111111100000000111111100000000011111111111001
1100011111111100011110001111101111001111111110000000001100111100000001100001110000000111111111111001
1110000011111100011111000111000111001111111100000000001100111000000001100000110000000111111111111011
1110000001111100011111000000000011000000011000000000001100111000000001000000000000000111111111111111
1110000001111100011111100000000001100000000000100000001100111000000000000000000000000100111111111111
1100000000111100011111100000000001110011000001110000001100110000000000000000000000000000011111111111
1100000000000000011111000001100001111111000011110000000000000000000000000000111100000010011111111111
1100000000000000011110000011100001111111000011100000000000000110000000000001111111111110011111111111
1100000000000000001110000111100001111110000011000000000000001110000000000011111111111110000000111111
1110000000000110001111001111100000000000001100000000000000001110000000000111110011111110000000001111
1111000000001111111111111111100000000000011100000000000000001110000000000111100000000000000000001111
1111000000001111111111111111100000000000011100000000000000001111000000001111100000000000000000000111
1111000000001111111111111111100000000000011111100000000000011111111100001100110000000000000010000111
1110000000011111111111111111100011100000011111110000000000111111111110000000010000000000000111000111
1110000001111111111111111111100111100000000111110000000000111111111110000000010000000010000111000111
1110000001111111111111111111111111110000000111111000000000011111111110000000110000000110001111000111
1110000001111111111111111111111111111000001111111111110000011111111111000000000000011110011110000111
1110000000011101111100000011111111111000001111111111110000011111111111000000000000111111111100000111
1110000000000001111100000001111111111000001111111111111000111111111111000000000001111111111100000111
1110000000000001111000000000000000000000011111111111111111111111111111000011100011111111111100000111
1110001000001111111000000000000000000001111111111111111111111111111111000111111111111111111100001111
1111011111111111111100111111111111000011111111111111111111111111111111111111111111111111111111111111
1111111111111111111111111111111111111111111111111111111111111111111111111111111111111111111111111111