
1111111111111111111111111111111111111111111111111111111111111111111111111111111111111111111111111111
1111111111111111111111111111110011111111111111000111111111100011111111111111111111111111111111111111
1111111111111111111000111111000011111111111110000111111111000011001111111111001111111111111100110011
1111111111110001111100011110000011111111111110001111111110000000000111111100000111110011111000000001
1111111111100001111110000100000011101111111111000111111110000000000111111000000111000011110000000001
1111111111000011111111000000000011000111111111000011111111000000001111110000000110000011100001110011
1111111111000001111111100000000011000111111111000001111111100000011111110000000000000001100011111111
1111111111000000111111100000000000000111111111000000001111110000000111110000000000000001100011111111
1111111111000000111111100000000000000111111111000000000011111000000011100000000000000001100011111111
1111111110000000111111110001100000000111111111000000000001111000000000000000000000000000000111111111
1111111000000001111111111111110000000111111110000000000000011000000000000000000000000000001111111111
1111111000001111111111111111111000001111111000000000000000000000011000000000000000000000001111111111
1111111100011111111111111111111000001111110000000001100000011000111111000011000000000000000111111111
1111111100011111111111111111111000001111110001100000110000111111111111000111100000000000000011111111
1111111000111111111111111111111100001111100001110000111100111111111111101111110001100100000001111111
1110000000011111111111111111111110001111100011110000111111111111111111111111111001111110000001110011
1100000000001111111111111111100110001100000111110000111111111111111111111111111001111111111111100001
1100000000000000111111111111000010000000001111100000111111111111111111110011110000001111111111000001
1000000000000000011111111111000011000000001111100000011111111111111111100001110000000111111111000011
1000000000000000011111111111000011111100001111100000001111111111111111100001111000000000111110000111
1100000000000000001001111111000111111110011111100001111111111111111111110001111110000000011000001111
1110000000000000000001111110000111111110001111100011111111111111111111111000111111000000000000011111
1110000000000000001001111110000111111100001111001111111111111111111111111000011111000000000000011111
1110000011000000011000000100000111111100011110011111111111110111111111110000000111000000011100001111
1111000111110001111000000000000111111100111111111111111000000111111111110000000010000000011111000011
1111000111111111111100000000001111111001111111111111110000000011111111110000000000000000111111100011
1111000111111111100110011000001111111011111111111111110000000001111111110000011100000000111111111111
1111100111111111100000011100000111111111111111111111110000100001111111111000011111000000011111111111
1111111111110001100000011110000011111111111111111111111111100000000111111100011111100000000011111111
1111111100000000000000011111000001111111111111111111111111100000000011111110000011100000000001111111
1111111100000000000000001111000000111111111111111111111111000000000011111111000011000000100001111111
1111111110000000000010000111110000111111111111111111111111000000000001111111000111000001100001111111
1111111111000000001111111111111100111111111111111111111111000000000000111110001111000011100000111111
1111111111100000011111111111111111111111111111111111001111000000010000011000001111001111100000001111
1111111111110000011111111111111111111111111110000010000001000001111000000000011111111111110000000111
1111111111111000011111111111111111111111111100000000000000000011111100000000011111111111111000000111
1111110001111000001111110011111111111111111000000000000000000111111100000000001111111111111111000011
1111100001111000001111100001111111110111000000000000001100001111111000000000000111111011111111100011
1111100000111000011110000011111111100000000000000001111100011111110000000000000111111001111111100011
1111100000010000111110000111111100000000000000000001111110111111111000111000100011110000111111000111
1111100000000001111110001111111000000000001110110000111111111111111000111101110001100000011111001111
1111100000000000111110001110000000000000001111110000111111111111111000111111110000000000011111111111
1111110000000000011110000000000000000000000111100000111111111111111000111111110000000000011111111111
1111110000000000001100000000000000000001111111000000111111111100000001111111100000000000111111111111
1111110000000000000000010000000000011111111110000001111111111000000000011111110011100000111111111111
1100000000110000000000111000000000111111111100001001111111111000000000011111111111100000111111111111
1100000011111111000001111110000001111111111101111001111111111100000000011111111111100000111111111111
1000000011111111110011111110000011111111111111111011111111111000111000111111110000000000011110000111
1000000011111111111111111110001111111111111111110001111111111000111111111111100000000000000000000011
1111110011111111111111111110011111111111111111100011111111111000111111111111100001100000000000000011
1111110001111111111111111100011111111111111111100011111001110000011111111111000011110001110000000011
1100000000011111111100111000111111100011111111100111111000111000011111100000000011110011111000000111
1000000000011111111000000000111111000001111111100111111000111000111111000000000011100111111100000111
1000010000111111110000000000111110000000111111000111111100011000111111000000000000000111111111001111
1111111001111111100000000100111110000000000000000111111110000001111110000000000000000011111111000011
1111111111111111000000001110011110000000000000000011111110000000111110000000000000000011111111000001
1111111111111111000000011111001110000000000000000011111111000000111110110000000000000111111111111001
1111111111111111101100111111001111000011000000000011111111100000111111110000000000001111111111111001
1111111111111111111111111111111111100111111100011111111111110111111111111011111111111111111111111111
1111111111111111111111111111111111111111111111111111111111111111111111111111111111111111111111111111