
1111111111111111111111111111111111111111111111111111111111111111111111111111111111111111111111111111
1111111111111111111111001111110011111111111111111110000001111110000011111111001111111111111111111111
1111111111111111111000000111100001111111111111111100000000111100000001111110000111111111111100111111
1111111111111111110000000010000000111111111111111100000000000000000001111110000000000001110000000011
1111111110011111110000000000000000000001111111111110000000000000000001111110000000000000000000000001
1111111100001111100000000000000000000000111111111111111000000000000000111111000000000000000000000001
1111111000000000000011000011111000000000111111111111111100000000000000011111110000000000000000000001
1111110000000000000111100111111100000000111111111111111111111000000000001111111000000000000000000011
1110000000000000001111111111111100000000111111111111111111111111000000000111111000000000000000000111
1100000000000001111111111111111110000000111111111111111111111111100000000011110000000000000000000111
1100000000000011111111111111111111000000111111111111111111111111110000000011110000000000000000001111
1100000000011111111111111111111111000001111111111111111111111111111000000011111000000000000000001111
1100000000111111111111111110001111100001111111111111111111111111111000000011111000000001000000000111
1100000000111111111111100000000111110011111111111100011111111111110000000011110000000011100000000111
1100000001111111111111000000000011111111111110000000001111111110000000000001100000011111100000000111
1000000111111111111110000000000011111111111100000000001111111100000000000000000000111111100000000011
1000001111111111111100000000000001111111111100000000011111111100000001111000000001111111100000000001
1000001111111111111100000000000000111111111000000000111111111100000011111100000011111111100000000001
1100011111111111111110000000000000111111110000000000111111111100001111111100000011111111100000000001
1100011111111110001111110000000000111111100000000001111111111100011111111000000111111111000000000011
1100001111111100000111111000000001111111000000000011111111111000011111110000000111111110000111000011
1100000001110000000111111000000011111111000000000011111111111000001111110000001111111100001111100111
1100000000000000000111111100000011111111000000000011111111111000000011111000001111111000111111111111
1110000000000000000111111100000111111111100110000111111111111000000000011110011111110001111111111111
1111000000000000000011111100000111111111111111000111111000110000000000001111111110000001111111111111
1111100000000000000000111110000111111111111111000111110000000000011000001111111100000001111111111111
1111110000001111000000011110000011111111111111000011110000000000111100001111111100000000111111111111
1111110000011111100000011110000001111111111111100001111000000000111100001111111110000000111111111111
1111110000011111100000011110000001111111111111110000111100000000111110011111111110000000111111001111
1111111000111111100000001110000000111111111111110000111110000001111111111111111110000000011110000111
1111111000111111110000001111000000111111111111110000111111110011111111111111111100000000000000000111
1111110000011111111000000111111000011111111111111000011111111111111111111001111100000000000000000111
1111100000000011111100000111111100011111111111111000011111111110000011110000111110000000000000000111
1111100000000001111100000111111100111111111111111000001111111000000001100000011111000001100000000111
1111100000000001111100001111111000111111111111110000000111110000000000000000001111100011110000000111
1111110000000001111000011111111000111111111111000000000000000000000000000000000111100011111100000111
1111111100000000110000011111111000111111001110000000000000000001111000000000000111100001111111001111
1111111110000000000000011111110001111110000000000000000000000011111100000000001111100000001111111111
1111111110000000000000001110000011111110000000000000000000000011111100000000011111000000000111111111
1111111100000000000000000000000011111110000000000001110000000001111100000000011110000000000011111111
1111100000000000000000000000000001111110000000000011111000000001111100000000011110000000000001111111
1111000000000000000000000011100000111100000001100011111000000000111110000000011110000000000000111111
1110000000000000000000000111110000011000000111110001110000000000011111000000111100000000000000011111
1110000000000000000000000111111000000000001111110000000000000000011111110001111100000000000000011111
1111000111111000000000001111111111000000001111110000000000000000111111111111111100000110000000111111
1111111111111100000000111111111111100000001111110000000000000000111111111111111000001111000001111111
1111111111111100000001111111111111110000000111110000000000000000111111111111100000001111111000111111
1111111111111100000001111111111111111000000111110000000000000000011111111110000000000111111000111111
1111111111111100000001111111111111111000000011111000000000000000001111100000000000000111111100011111
1111100111111110000001111111111111111100000001111110000011000000000000000000000000000111111110000111
1111000011111110000000111111111111111111000001111111000111100000000000000000000000000011111110000011
1111000001111110000000001111111111111111100011111111111111110000000000000000000001100001111110000011
1111100000011110000000000111111111111111100011111111111111111000000000000000000011110001111110000111
1111110000001100000000000111111111111111000001100000000001111000000000000001111111110001111111001111
1111110000000000000000000011111111111110000000000000000000110000000000000011111111110000111111111111
1111100000000000000000000001111111111110000000000000000000000000000000000011111111110000111111111111
1111100000000000000000000011111111111111000000000000000000000000000000000011111111111001111111111111
1111110011100000000110011111111111111111100011100000011100000000000000000011111111111111111111111111
1111111111111111111111111111111111111111111111110000111110000111111000000111111111111111111111111111
1111111111111111111111111111111111111111111111111111111111111111111111111111111111111111111111111111