
1111111111111111111111111111111111111111111111111111111111111111111111111111111111111111111111111111
1111111111111111111111111111111111111111111111111111111111111111111001111111111111111111111111111111
1111000011111111110011111111111111111111111111111111111111111111110000111111001111000011111111111111
1111000001111111110001111111111111111111111111111111111111111001110000111111000000000011111111111111
1111000001111111111000111111111111111111000001001111111111111000111000111110000000000011111111111001
1111000000111111111100011111111111110000000000000111111111111000111000011110000000000011111111111001
1111000000111111111100001111111110100000000000001111111111100000110000001110000000100111111110011001
1111111100000111111000011111111100000011100000111111111100000000000000000100000000111111111100000001
1111111110000011111001111111110000001111100001111111110000000000000100000000000001111111111100000001
1111111111000011110001111111100000001111100011111111100000000000001100000000000001111111111000000011
1111111111000001100001111111000000000111110011111111000000011100011100000001000011111111111000000111
1111111110000000000001111110000000000111111001111111000000111111111100000111111111111111111100011111
1111110000010000000011111110000000000111111000011111000001111111111110001111111111111111111100111111
1111111000011000010011111110000000000111111000000011100000111111111100011111111111111111111100111111
1111111000001100110001111111001110001111111100000011100000011111111000111111111111111110011000011111
1111111000000111110001111111111110011111111110000111110000111110000000111111111111111100000000001111
1111111000000111110000110001111110011111111111111111111111111100000001110011111111111000000000000111
1111111000000111110000000000111100011111111111111111111111111000111111100001111111110001111111000011
1111111000000111110000000000010000011111111111111111111111110001111111000000111111110001111111100011
1111000000000111100000000000000000000111111111111111111111110001111110000000011111100011111111111111
1111100000000111000000000000000000000001111111111111111000110000111100000000011111001111111111111111
1111111110000111100000000000000000000001111111111100000000110000000000000000001100011111111111111111
1111111110001111100000000000000000001111111100111000000000000000000000000000000000111100001111111111
1111111111111111100000000000000000011111111000000000000000001111000000000010000001111100000111111111
1111111111111111000000000000010000111111111000000000000000011111111111111111000011111100000000111111
1111111111111111110000000000110000111111110000000000000111111111111111111111000111111100000000001111
1111111100111111110000000000110000111100000000000000011111111111111111111111001111111000000000001111
1111111000001111111000000100110001111000000000000000111111111111111111111110011111111100000000001111
1111111000001111111100001110110001110000000000000000111111111111111111111110011111111110000000011111
1111110000001111111111011111110000000000011100000001110111111111111000111100111111111100000000111111
1111100000011111111111111111111000000000111110000011110111111111110000000000000000000000001111111111
1111000000001111111111111111111000000011111110000011110111111111110001100000000000000000011111111111
1100000000000011111111111111110000000111111111000001100011111111110011110000000000000000111111111111
1100000000110001111111111111000000001111000111110001100001111111110011110000000110000000111111111111
1110000001111000111111001110000000011100000011111001100000011111111001110000001111000000000111011111
1110000001111101111100001100000000001000000001111111111000001111111000111000111111100000000110011111
1110000000111111111100000000000000000000000001111111111000001111111101111100111111100000001100011111
1100000000011111111110000000000000000000100000111111111100001111111000111100111111100000011000011111
1100000000001111111110000111100000000011110000011111111110001111111000111100111111100000010000001111
1100000000000111111110001111110000000111111000011111111110001111111000111111111111110000000000000111
1100000000000001111110011111110000001111111000111111111100000111111100011111111111100000000000000011
1100000000000000111111111111110000000111110001111111111000000111111110000001111111000000000000000011
1100000000000000111111111111111000000011110001111111110000001111111111000001111110000000000000000011
1111000000000000000011111111111000000011110001111000000011111111111111100001111100000000000000000011
1111000000000000000011111110111000000011111000110000000111111111111111110011111100000000000000000011
1110000000000000000111110000000000000011111100000000011111111111111111111111111000001000000000000011
1100000000000000000111100000000110000111111110000000111111111111111111111111100000011110000000000111
1100000000000000000000000000111110001111111111100000111101111111111111111000000000011111111000001111
1100000001000000000000000001111110111111111111100000000000000111111111100000000000001111111100001111
1100000011100000000000000011111111111111111111100000000000000111111100000000000000000111111111000111
1111000011100000000000000111111111111111111111111100000000000111111000000000000000000011111111000011
1111000111100000000000000011111111111111111111111111100000001111000000000000000111100011111000000111
1111001111110000000000000001111111111111111111111111111000011110000000000000001111110011110000011111
1110001111111000000000000000111111111111111111111111111100011110000000000000001111110011100000111111
1110001111111000000111110000111111111111111111111111111000011111000000000000001111100111000111111111
1110001111111110001111110011111111111111111111111111100000011111111111000000001111001111001111111111
1100001111111111011111110111111111111111111111111111000000011111111111100000001111111111001111111111
1100000111111111111111111111111111111111111111111111001100011111111111110000011111111111001111111111
1111101111111111111111111111111111111111111111111111111111111111111111111111111111111111111111111111
1111111111111111111111111111111111111111111111111111111111111111111111111111111111111111111111111111