
1111111111111111111111111111111111111111111111111111111111111111111111111111111111111111111111111111
1111110001111111111111111111111111111111111111100111111111111111111111111100000111111111111111111111
1111100000111111111111111111111111111111111111000011111111111111111111111000000000011111111111111111
1111100000111111111111111110011111111110000110000011111111111111111111110000000000001111111111111111
1111000000111111111111111100000111111100000000000011111000111111000111110000011000000000111111110011
1110000000111111111111111100000011111100000000000001110000011110000011110000111100000000000000000001
1100000000011111111111111100000011111100000000000000000000000000000001100001111100000000000000000001
1100000000000111111111111100000011111100000000000000000000000000000000000011111100000000000000000011
1100000000000011111111111100000011111100000011000000000000000000000000000111111110000000001111111111
1100000000000001111111111110000001111110000111111100000000000000000000001111111111110011111111111111
1100000000000001111111111111000001111111111111111110000000011110000000011111111111111111111111111111
1100000000000001111111111111100001111111111111111111000000111111100000011111111111111111111111111111
1100000000000011111111111111100011111111111111111111000000111111110000001111111111111111111111111111
1100000000001111111111111111000011111111111111111110000000111111110000000111111111111111111111111111
1000000000011111111001111110000011111111111111110000000000111111110000000011111111111111111111111111
1000000000011111110000110000000001111110011111100000000001111111100000000011111111111111111111111111
1000000000001111100000000000000000111100001111100000000011111100000000000111111111111111111111111111
1100000000001111100000000000000000111100001111000000001111111000000000001111111111111111111111111111
1100000000001111000000000000000000000000000110000000011111111000000000001111001111111111111111111111
1100000000001111000000011111000000000000000000000000011111111100000000000110000111111110001100111111
1000000000000111100111111111100000000000000000000000111111111111110000000000000111111100000000011111
1000000000000111111111111111100001111110000000000000111111111111111000000000000111111100000000011111
1100000000001111111111111111100001111110000000000001111111111111111111000000000111111000000000111111
1100000000111111111111111111100001111110000000011111111111111111111111100000000011110000000001111111
1110000001111111111111111111110011111100000000001111111110011111111111100000000000000000000001111111
1111000001111111111111111111111111111000000000000011111100001111111111000000000000000001100000111111
1111100000111111111111111111111111111000000000000000000000001111111111000000000000000011110000111111
1111100000111111111111111111111111111100000000000000000000001111111111000000000000000011110000111111
1111000000111111110011001111111111111110000000000000000000000111111111100000000000000011111000011111
1110000000111111100000000111111111111110000000000000000000000111111111111000000000000011111000000111
1100000000011111100000000011111111111110000000000000000000000111111111111100000000000011111000000011
1100000000001111110000000011111111111111000011100000000000001111111111111100000000000011110000000011
1100000000000111111000000111111111111111111111110000000000001111111111111100000000000001100000000011
1000000000000011111000011111111111111111111111111000000000001111111111111000000000000000000000000011
1000000000000000110000111111111111111111111111111000000000000111111111111000000000000000000000000001
1000000000000000000000111111111111111111111111111000000000000011111111111100000000000000000000000001
1100000011100000000000111111100111111111111111111000000000000011111111111111100111000000000000000001
1100000111110000000000111111000011111111111111111000000000000001111111111111111111111111110000000011
1110000111111111100000011110000011111111111111110000000000000000111111111111111111111111111000000111
1111100011111111110000000000000111111111111111000000000000000000001111111111111111111111111000000111
1111100011111111110000000000001111111111111110000000011001100000000011111111111111111111111000000111
1111110001111111110000000000001111000011111110000000111111110000000001111111111111111111110000000111
1111111000011111111000000000000110000001111100000000111111110000000001111111111111111111000000000111
1111111000001111111111000000000000000000111000000001111111100000000001111111111111111110000000000011
1111110000001111111111000000000000000000000000000011111111000000000011111111111111111100000000000011
1111110000000111111111000000000000000000000000111111111110000000000011111111111111111000000000000111
1111110000000011111110000000000000000000000001111111111110000000000011111111111111111000000001111111
1111110000000001111100000000000000001100000001111111111100011110000111111111111111111000000011111111
1111110000000000111100000000000000011110000001110000111000111111001111111111100011110000000011111111
1111110000000000111110011000000000011111000011100000000001111111011111111111000001100000000111111111
1111100000000000111111111100000000001111100111000000000111111111111111111111000000000000000111111111
1111100000000000011111111100000000000111111111000000011111111111111111111111100000011000001111111111
1111100000000000011111111100000000000000111110000000111111111111111111111111100001111100001111111111
1111100000000000011111111000000000000000011110000001111111111111111111111111100011111110001111111111
1111100000000000001111110000000000000000001111000011111111111111111111111111000011111111000111111111
1111100000000000000111110000110000000000001111100111111111111111111111111000000011111111100011111111
1111100000110000000111111001111000000000001111111111111111111111111111110000000001111111111111111111
1111110001111000001111111111111111111000001111111111111111111111111111110000000001111111111111111111
1111111111111100111111111111111111111110011111111111111111111111111111111000000011111111111111111111
1111111111111111111111111111111111111111111111111111111111111111111111111111111111111111111111111111