
1111111111111111111111111111111111111111111111111111111111111111111111111111111111111111111111111111
1111111111111111111111111111111111111111111111111111111111111111111111111111111111111111111111111111
1111111111111111111111111111111111111111111111111111111111111111111110001111111111111111111111111111
1111111111111111111111111111111111111001111111111111111111111111111100000111111111111111111111111111
1111111111111111111111111111111111110000111111111111111111111111111100000111111111111111111111111111
1111111111111111111111111111111110000000111111111111111111111111111100000111111111111111111111111111
1111111111111111111111111111111100000001111111111111111111111111111100000111111111111111111111111111
1111111111111111111111111111111000011111111111111111111001111111111100000011111111100011111100111111
1111111111111111111111111111111000111111111111111111110000011111111110000001111111000000011000011111
1111111111111000111111111111110001111111111111111111110000000111111111110000011111000000000000001111
1111111111110000011111111111110001111111111111111111111000000011111111111100001111000000000000001111
1111111111000000000011111111100011111111111111111111111111000011111111111111000110000000000000001111
1111111110000000000001111111100011111111111111111100011111000111111111111111100000000000000000011111
1111111110000000000000111111000111111111111111111000000000001111111111111111110000000000000001111111
1111111110000000000000011111000111111111111111111000000000011111111111111111110000000000000011111111
1111111110000000000000011110001111111111111111111000000000011111111111111111110000000000000011111111
1111111111000000000000111110011111111111111111111100000000001111111000011111110000000000000001111111
1111111111100000000001111100000000000111111100111110000000000111110000001111100000000000000000111111
1111111111100000000011111100000000000011111000011111000000000000000000001111000000000000000000011111
1111111111110000000011111100000000000001110000011111111000000000000000011110000000000000011000001111
1111111111111110000011111000000000000000000000001111111100000000000000011110000000000000111100000111
1111111111111111000011111000000011000000000000000111111110000000000000001100000000000000111100000111
1111111111111111000001111100000111100000000000000011111111000000000000000000000000000000011000000011
1111111111111111000001111100000111100000000000000000111111100000000000000000000000000000000000000001
1111111111111110000001111000001111100000001100000000011111100000000000000000000000000000000000000001
1111111111111110000001111000001111100000011110000000011111100000000011000000000000000000000000000001
1111100011111111000001111100001111000000111111000000011111110000000111111100000111100110000000000011
1111000001111111000001111100000110000001111111111100111111111000000111111110011111111111000000000111
1111000000011110000001111000000000000011111111111111111111111000001111111111111111111111100000111111
1111000000000100000000111000000000000011111111111111001111110000011111111111111111111111100001111111
1111100000000000000000111100000000000001111111111110000111110000011111111111111111001111100001111111
1111111111100000000000111110000000000001111111111110000011100000001111111111111110000111110001111111
1111111111111000000001111110000000000011111111111111000000000000000001111111111100000011111000111111
1111111111110000000111111100000000000011111111111111110000000000000000111111111100000001111000011111
1111111111110000011111111000000000000001111111111111111000000000000000111111111110000001111000001111
1111111111110000111111110000000011100001111111111111111100000000000000111111111111000000110000000111
1111111111110000111111111000000111110001111111110001111100000000000000111111111111100000000000000111
1111111111110000111111111111000111110001111111100000111000000000000000111111111111110000000000000111
1111111111110000011111111111100111100001111111000000000000000000000000111111111111111000000000000111
1111111111100000001111111111111111000000111110000000000000000000000000011111111111111100000000001111
1111111000000000000111111111111111000000011100000000000000000000000000001111111111111110000000011111
1111110000000000000111111111111111000000000000000000000000000000000000001111111111111110000000111111
1111110001111000000111111111111111100000000000000000000000000000000000001111111111111110000000111111
1111111111111100001111111111111111111000000000000000000000000000000000001111111111111111000000011111
1111111111111100011111111111111111111100000000000000000000000000000110011111111110011111100000011111
1111111111111000011111111100011111111100001100000000000000000000001111111111111100001111100000001111
1111111111110000001111111000001111111100011110000000000000000000001111111111111100000111000000000111
1111111111100000000000110000000111111000011111000011111111100000000111111111111100000000000000000111
1111111111000000000000000000000111111000001111100111111111110000000111111111111110000000000000001111
1111111000001100000000000000000011111100001111111111111111111000000111111111111110000000000000011111
1111110000011110000000000000000001111100011111111111111111111100000111111111111110000000000000111111
1111110000111111000000000000000001111100111111111111111111111100000111111111111100000001100001111111
1111110000111111000000000000000001111000111110000011111111111000000111111111111100000011110001111111
1111111001111111000000000011000000110000011100000000011111111000000111111111111110000011111001111111
1111111111111111100111100111100000000000000000000000001111111000000111111111111111000001111001111111
1111111111111111111111111111100000000000000000000000001111111000000111111111111111100001111111111111
1111111111111111111111111111100000000000000000001100001111111100001111111111111111100001111111111111
1111111111111111111111111111110000000000000000011111111111111111111111111111111111110011111111111111
1111111111111111111111111111111111000111111111111111111111111111111111111111111111111111111111111111
1111111111111111111111111111111111111111111111111111111111111111111111111111111111111111111111111111