
1111111111111111111111111111111111111111111111111111111111111111111111111111111111111111111111111111
1111111100000000011111111111111111111111111111111111111111111111110001111100011111111111111111111111
1111111000000000011111111111111111111111111111110000111111111111100001111000011111111111111111111111
1111111000000000011110011111111111111111111111100000000111111111100001111000011111111111111111111111
1111110000110000111100011111111000111111111111100000000011111111100011110000111111111111111111111111
1111100011110001111000011111110000111111111111100001000001111111100011100000111111000000111111111111
1111100111110001111000011111100000011111111111100011111100000111000000000000011111100000011111111111
1111111110110000111000111111100000011100111111110111111100000000000000000000001111110000000111111111
1111111000010001111000000011000000011000111111111111111111100000000111111000001111110000000000000011
1111100000000111111000000000000000000000111111111111111111100000111111111000000111110000000000000011
1111000000000111111000000000000000000001111111111111111111100001111111111000000011110000000000000011
1111000000000111110000000000000000000000111111111111111111100011111111111000000011111000000000011111
1111000110001111110000110000111000000000000111111111111111100111111111110000000011111100000000111111
1111100111111111110000111101111000000000000001111111111111100111111111100011100001111111000001111111
1111100011111111110000111111111100000000000000111111111111000111111111100001110000111111100001111111
1111000011111001111000011111111110000100000000111110011111000111111111100001110001111111100000111111
1110000011110000111100001111000111001110000000011110000111100011111111000001110011111111100000011111
1100000011110000011100000000000011111110000000011111000111110000111111000011110011111111100000000011
1100000001110000001100000000000011111111000000001111000000110000111111000011110001111111110000000111
1100000000000000000000000000000011111111000110000000000000010000111111100011111000111111111100001111
1100000000000000010000000000000111111100001111000000000000000000111111100011111100111111111110011111
1000000000000000111110011000000111111000011111000001000011000000111111000001111111111111001111011111
1000000000000000111110011100000111110000111111001111000111100000111111000000111111111110000110001111
1000000000000000111110011100000111100000111111111110001111111100011111000000111111111100000000001111
1000000000000000011111011100000000000000111111111100011111111110000011100011111111110000000000001111
1111100000000000011111000000000000011111111111110000011111111110000001111111111111110000000000011111
1111100000000000111111000000000000111111111111100000111111111110000000111111111111111000001111111111
1111000000000000111111100000000001111111110011000111111111111111000000111111111111111000011111111111
1110000000000001111111100001100011111111000000001111111111111111111111111111111111110000111111111111
1110000000000011111100000011110011111110000000011111111111110111111111111111111111000000111111111111
1111000000000111111000000111110001111110011100111111001110000011111111111111111110000000111111111111
1111000000000111100000001111110001110111111110110000000100000011111111111111111000000000011000001111
1111000000001111000000111111110001100011111111110000001110000011111111111011110000000000000000000111
1110000000011100000000011111111000000000111111100000011111100001111111110000000000000000000000000111
1100000011111000000000000000111100000000011000000000011111110001111111110000000000000000000000001111
1100000111100000000000000000111110000000000000000000011111110000111111110000000000000000000000001111
1110001111000000000000000111111110000000000000000000011111110000111111110000000000000001111000000111
1110011111000000000000011111111100000000000000000000001000110000111111110000000000000000111110001111
1100011111000000000000111111111000000000110000000000000000000000111111110000000000000000001111111111
1000011110000000000001111111111000011001110000000000000100000000111111100000000000000000000111111111
1000111110000000000011111111111000111111110000000000001100000000011111100000000000000000000111111111
1000011111000000000111111111111000111111110001000011111100000000111111111111000000000000000111111111
1000011111000000000111111111111000111111111011100011111100011001111111111111000000000000000011011111
1000011111000000000111111111111000111111111111100111111000011111111111111000000000000000000000001111
1100111110000000000111111111111000111111111111111111111000111111111111110000000000000000000000000011
1111111100000000000011111111111000011111111111111111111001111111111111110000000000000001000000000011
1111111000000000000001111111110000000011111111111111111001111111111111100000000000000111111100000111
1111110000000000000000111111110000000111111111111111110000111111111110000000000001111111111110001111
1111100000000000000001111111100000011111111111111111100000011111111100000000000011111111111110001111
1100000000000011100011111111100000111111111111111111110000011111111100000001000011111111111100001111
1100000000111111110011100011100001111111111111111111111000001111111000000011100111111111110000001111
1100111111111111110011100011100011111111111111111111111100000111100000000111111111111111100000001111
1100111111111111100111110000000000011111111111111111111111110000000000001111111111111111000011111111
1100111111111111111111111100000000001111111001111111111111111000000000011111111111111111000011111111
1100111111111111111111111111110000001111111000000001111111111001111100000000001111111110000111111111
1111111111111111111111111111111000001111111100000000111111111001111110000000000111111110000011011111
1111111111111111111111111111111111001111111110011000110000010001111111000000000011111111000000011111
1111111111111111111111111111111111111111111111111100000000000011111111111000011111111111110011111111
1111111111111111111111111111111111111111111111111111100000010111111111111111111111111111111111111111
1111111111111111111111111111111111111111111111111111111111111111111111111111111111111111111111111111