
1111111111111111111111111111111111111111111111111111111111111111111111111111111111111111111111111111
1111111111111111111111111111111111001111111111111111111111111111111111111111111111111111111111111111
1111111111111111001111111111111100001111111111111111111111111111111111111111111111111111111111111111
1111111111111110000111111111111000001111111110011111111111111111111111111111111111111111111111111111
1110011111111100000011111111110000011111111100001111111111111111111111111111111111111111111111111111
1100001111111000000011111111100000011111100000001111111110011111111111111111111111111111111111111111
1100000111111000000011111111000000001111000000001111000000001111111111111111111111111111111111111111
1110000111111100000011111111000000000000000000011110000000001111111110001111111111111100110001111111
1110000011111110000011111110000000000000000000111100000000001111111100000111111111111000000000111111
1100000000011110000011111100000000000000000111111100000000001111111100000011111111110000000000001111
1100000000001111000001111000001110000000001111111100000000000111111110000001100011110000000000000111
1110000000001111100000000001111111000000011111111100000000000111111111000000000001110000000000000111
1110000000000111111100000011111111000000111111111100000000000111111111100000000001110000000000000111
1110000000000111111110000111111111000001111111111110000011001111111111100000000011111000000000000111
1111000000000111111110000111111111000001111111111110000111111111111111000000000011111100000000001111
1111111000000011111110000011111111100001111111111110000111111111111111000000000001111110000000111111
1111111100000001111110000001111111110001111111111110000111111111111111000000000000111111000001111111
1111111110000000011110000000011111111000111111111110000111111111111111000000000000011111000001111111
1111111111000000000010000000001111111000011111111110000011111111111110000000000000011111000011111111
1111111111110000000000000000001111110000011111111111000001111111111100000000000000111111000111111111
1111111111110000000000000000011111110000011111111111100000111111100000000000000011111111000111111111
1111000000000000011100000110011111110000011111111111100000111111000000000000000111111111000111111111
1110000000000000011100001111001111100000001111111111000000111111000000000000000111111111000011111111
1110000000000000111100001111001111000000000111111111000000011111000000000000000011111111100011111111
1111001100000001111110011111111111000000000111111110000000000110000011000000000011111111110001111111
1111111110000001111111111111111111000000001111100000000000000000000111100000000011111111110001111111
1111111110000001111111111111111111000000011111000000000000000000000111100000000001111111110001111111
1111111110000000111111111111111111100000011110000000000000000000001111110000000000111111100001111111
1111111110000000011111111111111111111000001100000000000000000001111111111000000000111111100001111111
1111111111000000000111111111111111111100000000000000000000110011111111111110000000011111110000111111
1111111111000000000011111111111111111111000000001111000001111111111111000111000000001111111000001111
1111111110000000000011111111111111111111000000011111100001111111111110000010000000001111111000000111
1111111000000000000011111111111111111111000000011111100001111111111100000000000000001111111000000011
1111110000000000000011111111111111111110001100111111000001111111111100000000011000001111111000000001
1111100000000000000011111111011111111110011111111111000001111111111000000000111100000111110000000001
1111000000000000000011111110011111110000001111111111000001111100000011000001111110000000000000000001
1110000111000000000011111100011111100000001111111111100001111000000111111111111110000000000000000001
1100001111100000000011111100011111000000001111111111100000110000000111111111111100000000000000000001
1100011111110000000001111110011111000000011111111111000000000000001111111111111100000000000001100001
1000011111111100000001111110001111000001111111111100000000000000011111111111111100000000000011110011
1000011111111110000001111110000110000011111111111000000000000000011111111111111110000000000011111111
1000001111111110000011111111000000000111111111100000111000000000111111111111111111000000000011111111
1000001111111110000011111111100000001111111111000001111100000011111111111111111111100000000001110011
1100011111111100000111111111111110011111111111000011111100000111111111111111111111110000000000000001
1111111111100000000111111111111111111111111111100111111110001111111111111111111111110000000000000001
1111111111000000000011111111111111111111111111111111111111111111111111111111111111111000000000000011
1111111100000000000011111111111111111111111111111111111111111111111111111111111111111111100000001111
1111111000000000000001111111111111111111111111111111111111111111111111111111111111111111110000011111
1111111111111000000000111111111111111111111111111111111111111111111111111001111111100111110000011111
1111111111111100000000011111111111111111111111111111111111111111100000110000111111000011110000011111
1111111111111110000000000111111111111111111111111111111111111111000000000000011111000001100000011111
1111111111111111000000000011111111110001111111110011111111111111000000000000001111000000000000001111
1111111111111111000000000011111001100000000111000001111111111110000001100000000110000000000000000011
1111111111111110000000000001100000000000000000000001111111111110000011110000000000000000000000000001
1111111111111110000000000000000000000001111000000011111111111111000111111000000000000000000000000001
1111111111111111000011110000000000000111111100000011111111111111111111111111111100000000000000000001
1111111111111111100111111000000000001111111100000011111111111111111111111111111110000111000000000001
1111111111111111111111111111000111111111111100000111111111111111111111111111111111001111100000000001
1111111111111111111111111111111111111111111110011111111111111111111111111111111111111111110001100011
1111111111111111111111111111111111111111111111111111111111111111111111111111111111111111111111111111