
1111111111111111111111111111111111111111111111111111111111111111111111111111111111111111111111111111
1111111111111111111111111111111111111111111111111111111000111111111111111111111111111110001111111111
1111111111111111111111111111111111111111111111111111000000011111111111111111111111111100000111111111
1111111111111111100111111111111111111000011111111110000000001111111111111111111111110000000111111111
1111111111110000000011111111111111000000001111111110000000000011111100110001111111100000000011111111
1111111110000000000011111111111110000000001111111110000000000001111000000000000011000000000000001111
1111111100000000000001111111111110000000001111111100011000000000100000000000000000000000000000000111
1111111100001100000000011111111110000000011111110000111100000000000000000000000000000000000000000111
1111111110011110000000000011111100000000111111100001111111000000000000000000000000000000000000001111
1111111111111111000000000000000000000001111111000001111111100000011111100000000000000000000000001111
1111111111111111000000000000000000000001111110000011111111100000111111110000000000000000000000011111
1111111111111111000000000000011100000001111110000111111111110011111111111000000000000000000111111111
1111111111111111000000000000111110000011111111001111111111111111111111111110000001110000001111111111
1111111111111111000000000000111111111111111111111111111111111111111111111111100011111000001111111111
1111111111111110000000000000111111111111111111111111111111111111111111111111111111111000001111111111
1111111111111100000000000001111111111111111111111111110011111110000001111111111111111100011111111111
1111111111111000000000000011111111111111111111000001100001111100000000111111111111111100011111111111
1111111111110000000000011111111111111111111110000000000000111000000001111111111111111100011111111111
1111111111110000000011111111111111111111111100000000000000000000000011111111111111111000001111111111
1111111111110000000111111111111111111111111100000000000000000000000111111111111111111000000001111111
1111111111100000001111111001111111111111111110000000000000000000000111111111111111110000000000111111
1111111000000000001111110000111111111111111111000000011110000000000111111111100110000000000000111111
1111110000000000011111100000011111111111111111100000111111000000001111111111000000000000000000111111
1111110000000000011111000000001111111111111111100001111111000001111111111111000000000000000000111111
1111111000000000001111000000000111111111111111000011111111100011111111111111100000000000000000111111
1111111000000000001111000000000011111111111110000111111111111111111111111111100000000000000000011111
1111111000000000011111100000000011111111100000001111111111111111111111111111100000000000000000001111
1111110000000000111111110000000011111111000000011111111111111111111111111111100001110000000000001111
1111110000000001111111110000000111111111000000111111111001111111000011111111110011111000001100001111
1100100000000001111111110000001111111111000000111111110000111110000001111111111111111000011110011111
1000000000000000111111100000111111111111100000011111110000011000000001111111111111111000111111111111
1000000000000000001100000001111111111111100000011111110000000000000011111111111111111001111111111111
1100000000000000000000000011111111111111000000001111110000000000000111111111111111111001111111111111
1110000000000000000000000011111111111111000000001111110000000000011111111111111111111000111111111111
1111000000000000000000000011111111111111000000001111111000000000111111111111111111111000001111111111
1111100000000000001100000001111111111111000000000111111111000000111111111111111111110000000111111111
1111100000000000011110000000110001111110000000000000111111100000111111111111111100000000000011111111
1111100000000000011111000000000000111100000000000000011111100000011111110011111000000000000001111111
1111100000000000001111111000000000000000011000000000001111110000001111100001111000000000000000111111
1111110000000000001111111100000000000000111100000000000011111000001111100001111000000000000000011111
1111111000000000011111110000000000000001111111100000000011111000001111100000110000000000000000001111
1111111000011111111110000000000011000011111111110000000001110000011111110000000000000000000000000111
1111111100111111111100000011111111100111111111111001110001110000111111111000000000000000000000000011
1111111111111111111000001111111111100111111111111111110001100001111111111000000000000000000000000011
1111111111111111000000011111111111100111111111111111110001000001111111111100000000000011100000000111
1111111111111110000001111111111111111111111111111111111000000000111111111100000000000111100000000111
1111111111111110000011111111111111111111111111111111110000000000001111111100000000111111100000001111
1111111111111111001111111111111111111111111111111111100000000000000001111000000001111111100000001111
1111111111111110001111111111111111111111111111111100000000000000000000000000000011111111100000001111
1100111111111110001111100001111111111111111111111000000000000000000000000000000111111111100000001111
1000011111111110001111000000111111111111111111111000000000000000000110000000000111111111110000011111
1000001111111110001100000000111111111111111111111000000000000000001111110000000111111111110000111111
1000000011111110001000000000011111111111111111110000000000000000001111111000000111111111100001111111
1100000001111000000000000110000001111111111111110000000000000000001111111000001111111111100001111111
1111000000000000000000011111000000001111111111111001110000000000001111111100011111111111100000111111
1111100000000000001111111111000000000001111111111111111000000000011111111111111111111111100000011111
1111111111100000011111111111100110000000111111111111111100000000111111111111111111111111100000011111
1111111111110000011111111111111111110001111111111111111111100001111111111111111111111111100000111111
1111111111111000111111111111111111111111111111111111111111110011111111111111111111111111110001111111
1111111111111111111111111111111111111111111111111111111111111111111111111111111111111111111111111111