
1111111111111111111111111111111111111111111111111111111111111111111111111111111111111111111111111111
1111111111111111111111111111111111111111111111111111111111111111111111111111111111111111111111111111
1111111111111111111111111111111111111111111111111111111100111111111111111111111111111111111111111111
1111111111111111111111111111111111111111111111111111111000011111110011111111111111111111111111111111
1111111111111111111111111111111111111111111111111111000000011111100001111100111111111111110011111111
1111111111111111111111111111111111111111111111111110000000011111100000111000011111111111100000000111
1111111111111111111111111111111111111111111111111110000000011111000000000000011111111111100000000011
1111111111111111111111111111111111111110001111111110000000001110000000000000001111111111110000000011
1111111111111111111111111111110011111000000111111111000000001100000000000000000111111111110000000001
1111111111111111111111111111100000000000000011111111000000011100000000000000000011111111110000000001
1111001111111111111111111111100000000000000001111111000111111100000000110000000011111111111000000011
1111000111111111111111111111100000000000000000111110001111111000000001111000000011111111111100000011
1111000011111111001100000111100000001110000000011110001111111000000001111000000011111111111110000111
1111000001111110000000000011000000011111000000011110000111110000000001111100000111111111111110000111
1111100001111100000000000000000000111111000000001100000000000000000001111110000111111111111100000111
1111100011111100000000000000000001111111000000000000000000000000000011111111000011111111111000000111
1111100011111100000000000000000011111111100000000000000000000000011111111111100000000001110000001111
1111100011111110000000000000000111111111110000000000000000000000111111111111110000000000000001111111
1111100011111111100000000000000111111111111000000000000000000000111111111111110000000000000011111111
1111100011111111110000000000000111111111111000000000000000000000011111111111110000000000000011111111
1111110001111111111000000000000111110011110000000000000000000000011111111111110000000000000001111111
1111100000111111111100000000001111100001100000000000000000000000011111111111100000000000000000111111
1110000000011111111110000000001111000000000000000000000000000000011111111100000000000000000000111111
1100000000000011111110000000001111000000000000000000111000000000001111111000011100000000000001111111
1100000000000001111110000000001111000000000000000001111100000000001111110000111110000000000011111111
1100000000000000001110000000001111100111000000000111111110000000001111110000111111000000000011111111
1110000000000000000111000000011111111111100000001111111111000000001111111001111111111111110001111111
1111000000000000000111000000011111111111110000001111111111111110011111111111111111111111111000111111
1111100000000000001111000000011111111111111000011111111111111111111111111111111111111111111100011111
1111110000000000001110000000011111111111111000111111111111111111111111111111111111111111111100001111
1111111000000000000000000000011111111111111000111111111111111111111111111111111111100110000000001111
1111111000000000000000000000001111111111110000111111111111111111111111001111111111000000000000000111
1111110000000000000000000000000000001111110000111111111111111111111110000111111110000000000000000011
1100000000000000000000000000000000000111111001111111111111111111111100000111111111000000000000000011
1000000000000000000000000000001110000011111111111111111111111100000000000111111111110000001100000011
1000000000000000000000000001111111000011111111111111111111111000000000001111111111111000011110000011
1000000000000000000000000011111111000111111111111111111111111000000000011111111111110001111110000011
1100000000000000011000000011111111000111001111111111111111110000000000011111111111100011111110000111
1110000000000000111100000001111110001110000000111111111111100000000000001111111111100011111111001111
1110000000000001111100000001111100011110000000011111111111100000011100000111111110000111111111111111
1110000000000011111110000011111000011110000000001111111111110000111110000001111100000111111111111111
1110000000000011111111111111110000001110000000001111111111111001111110000000000000000111111111111111
1111000000000011111111111111000000000111000000001111111111111111111110000000000000001111111111111111
1111110000000001111111100000000000000111100000000111111111111111111110000000000000001111111111111111
1111111000000000111111000000000000000011000000000011111111111111111110000000111000000111111111111111
1111111111100000011100000000000000000000000000000000011111111111111111000011111100000011111111111111
1111111111110000000000000000000000000000000000000000001111111111111111000111111111100001111111111111
1111111111110000000000000000001000000000000000000000000111111111111111000111111111110000111111111111
1111111111110000000000000011111100000000000000000000000011111111111111000011111111110000000110000111
1111111111110000000000000111111100000000000000000000000011111111111111000001111111110000000000000011
1111111111110000000000000111111100000000000000000000000111111111111111100000111111110000000000000011
1111111111110000000000000011111110000000000000000000011111111111111111110000111111110000000000000011
1111111111100000011100000000011110000000000000000000111111111111111111110000011111110000000000000001
1111111111100011111110000000001100000000000011111000111111111111111111110000000111110000000000000001
1111100000000111111110000000000000011000000111111100011111111111111111110000000011110000000001100011
1111110000000111111110000000000000111100000111111110000000011111111111110000000011110000000011111111
1111111000000011111111000000000000111110001111111110000000011111111111110000000001111000000011111111
1111111100000011111111100000000001111111111111111111000000011111111111111001100001111110000111111111
1111111110000011111111111111111111111111111111111111100011111111111111111111110011111111111111111111
1111111111111111111111111111111111111111111111111111111111111111111111111111111111111111111111111111