
1111111111111111111111111111111111111111111111111111111111111111111111111111111111111111111111111111
1111111100011111111111111111111111111111111111111111111111111111111111111111111111111111111111111111
1111111000011111111111111111111111111111110111111111111111111111001111111111111111111111111111111111
1111111000011111111111111111111111111111100011111100011111111110001111111111111111111111111111100011
1111111000111111111111111111111111111111000001110000000000011100011111111100001111111111111111000011
1111111000011111111111111111111111111111000001110000000000001100011111111100001111000011111100000011
1111110000000000111111111111111111111111000001110011100000000000011111111100001110000001111000000111
1111110000000000011111111111111111111111100011111111110000000000001111111110000100000000000000111111
1111110000001100001100101111111111111111110011111111111000001100000011100111000000000000000001111111
1111110011111100000000000111111111111111110011111111111111111110000000000011000000000000000011111111
1111100111111100000000100011111111111111000001111111111111111110000000000000000110001100000011111111
1111000111111000000001110001111111111110000001111111111111111100000000000000001111111110000000111111
1110000011110000000011111000111101111100001111111111111111111000000000000000001111111111100000011111
1100000011110000001111111100000001111000011110011111111111110000001100000000001111111111110000011111
1100000011110000011111111100000000111000011000011111111111110000011100000111000111111111111111001111
1111100001110000111111111100000000111000000000111111111111100011111100001111000111111111111111100011
1111110001110001111111111110000000111000000000111111111111000111111110001111000110111111000111000011
1111110001111111111111111111100000110000000000111111111100000111111110000011000000011111000000000011
1111110001111111111111111111100000000000110000111111111100001111111110000011100000011111000000000011
1111110000111111111111111111000000000001110000111111111100000111111111000111111000000010000000000011
1111100000011111001111111100000000000011100000111111111110000011111111111111111100000000001100000011
1111110000001111000000111000000000001111000000111111111110000001111111111111111110000000001100000011
1111111000000111000000011000000000011111000000111111111111110001111111111111111111100000001111000011
1111111000000111000000001000000000111111111000011111111111110001111111110011111111111110001111000011
1111111000000110000000000000000001111111111100001111111111110001111111000011111111111111011110000001
1111110000000000001000000000000001111111001110011111111111110000111110000011111111111111110000000001
1111111000000000011100000000000011111000000111111111111111100000011100000011111111111111110000000011
1111111111000000111110000000000001100000000011111111111111100000001000011001111111111111111000011111
1111111111100001111110000000000000000000000001111111111111110000000000111101111111111111111100111111
1111111111110001111110000000000000001100000001111111111111111000000000111111111110011111111111111111
1111111111110011111110000000000000001111000001101111111111111000000000011111111000001111111111111111
1111111111100011111110000111000111000111110000001111111111111000000000011111110000000111111111111111
1111111111100000111111100011101111100011100000001110000011110000000000000001100000000001111111111111
1111111111110000011111110001111111100011000011100111000001100000000000000000000000000001111111111111
1110001111110000001111110001111111111111000111100011100000000000000000000000000110000001111111111111
1100000111100000001111111000011111111111000111110011100000000000000000111100111111000001111111100111
1100000011100000011111111000000111111111100111110001000000000000000001111111111111110001111111100011
1000000011100000111111111000000111111111110011111000000000000000000001111111111111111000111111000001
1000000011000000111111111000001111111111110011111100000001000000000000111111111111111100111111000001
1000000000000000111111111100011111111111000011111100000011100000000000111111111111111000011111000001
1000000000011111111111111110011111111110000011111100011111100000000001111111111111110000001111100001
1000000000111111111111111111111111110000000001111100111111100000000011111111111111110000000111100011
1001111000111111111111111111111111110000000001111111111111110000000111111111111111110000000011100011
1111111000110000111111111111100011110000100000111111111111111000011111111111111111110000000000100011
1111111000000000011111111111000001111111100000111111111111111100111111111111111111111000000000000011
1111110000000000000000111110000000111111110000111110111111111111111111111111111111111001100000000011
1111100011110000000000111100000001111111110000001100001111111111111111111111111111111111100000000011
1111111111111100000000111000000111111100110000000000001111111111111111111111111111111111100001111111
1111111111111111000000110000001111111100000000000000011110111111111111111111111111111111000011111111
1111111111111111000000100000011111111100000000000000000000011111111111111111111111111110001111111111
1111111111111111100000000000111111111100000000000000000000011111111111111111111011111110001111111111
1111111111111111100000000000111111111110000000000000111000000000110111100111110011111111001111111111
1111111111111000000000000000011111111111111000000001111100000000000000000011100011111111000111111111
1111111111110000000110000000001111111111111100000111111100000000000000000000000111111111100011111111
1111111111100000001110000000001111111111111100001111111100000000010001110000001111100111110001111111
1111111111110011111110001100001100111111111100011111111100000000111011111000011111000000000000111111
1111111111111111111110011110000000011111111100111111111100000001111111111000111111000000000000111111
1111111111111111111111111111100000011111111100111111111110000001111111110000111111100001100001111111
1111111111111111111111111111110000011111111111111111111111110011111111111001111111110011110011111111
1111111111111111111111111111111111111111111111111111111111111111111111111111111111111111111111111111