
1111111111111111111111111111111111111111111111111111111111111111111111111111111111111111111111111111
1111111111111111111111111111111111111111111111111000001111111111111111111111001100001111111111111111
1111111101111111111111111000111111111111111111110000000111101111111111111110000000000111111111111111
1111111001111111111111111000001111111111111111110000000111100000111111111110000000000111111111111111
1111110011111111111111111000000111100001110011110000000000000000011111111110000000000111111111111111
1100000011111111111100111000000111000000100001110000000000000000000111111100000000000111111111111111
1000000111111111111000000000000000000000000000000011111111000000000011111110000000001111111111111111
1110001111111111111000000000110000000000000000001111111111000000000001111111100100011111111111111111
1111000001111111111000000001111000011000000000011111111110000000000000001111111100011111111111011111
1111100000011011111101000011111110111000000001111111111110000000000000000111111100011111111110011111
1111111100000011111111100111111111110001100001111111111111000000000000000000111000111110000000011111
1111111110000001111111111111111111110011111001111111111111000000000000000000000000111100000000111111
1111111111100001111111111111111111111111111111111111110011000000000000000000000000000000000000111111
1111111111100001111111111111111111111111111111111111100000000000000000000000000000000000000000111111
1111111110000011111111111111111111111111111111111111100000000001000000000011110000000000000000111111
1111111100000111111111111111110011111111000011111111110000000011100000000111111000000000000000111111
1111111100001111111111111111110001111110000001111111111111001111100000001111111100000000000000000011
1111111100001111111111000111100000011100000000111111111111111111100000011111111110000000000000000011
1111111000000111111110000000000000111100000000111111111111111111100000011111111110000001110000000011
1111110000000011111100000000000001111100010000110011111111111111000000011111111111110001110000000001
1111100000000111110000000000000011111100011100000011111111111111000000011111111111110001110000000001
1111000000001111110000000000000011111100111100000111101111111110000000111111111111110011111111110001
1111100000001111110000000000000000000000111110001111000011111110000001111111111111110011111111110001
1111110000001111100000000000000000000001111111111110000001111100000001111111111111111011111111100001
1111111000000111000000000000000000000011111111111100000000000000000000111111111111111111111111000001
1111111100000011000000000000000000011111111111111100000000000000000000011111111111111111111100000001
1111111100000000000000000000000000011111111111111000000000000000001100000111111111111111111000000001
1111111100000000000000000000000000111111111111111000000000000011111100000011111111111111111000000011
1111101100000000000000000000001111111111111111111111110000000111111100000001111111111111111000011111
1111100000000000000000000000011111111111111111111111110000000111111100000000111111111111111000011111
1111100000000000011000000000111111111111111111111111110000001111000000000000111111111111110000011111
1111110000000000011000000001111111111110111111100111100000011110000000000001111111111111100000111111
1111111100000000001100000001111111111100011111000111100000111110000000000001111111111110000001111111
1111111100000000001100000000111111100000011111000111100001111111000000000011111111111100000011111111
1111110000000001001100000000011111000000111111000011100001111111000001111111111111111100100111111111
1111100001001111101110000000001110000111111111000000000011111110000111111111111111111100111111111111
1111000011111111111111100000001110000111111111100000000011111110001111111111111111111100111111111111
1110000011111111111111100000000100000011111111110000000011111110011111111111111111111111111111111111
1110000011111111111111100000000000000000111111110000000011111100011111110000000111111111111111111111
1100000111101111111111110001000000000000011111111000000001111100001111100000000111111111111111011111
1100001111000111111111111011000000000000011111111000111000111100001111100000000111111111111110001111
1110000000000011110000111111000000000000001111110001111100011110000111110000000111111111111100001111
1111000000000000000000111111000000000000001111100000111111111111000111110000000111111111111100001111
1111100000000000000001111111000000000111001110000000011111111111100111110000000111111110111110011111
1111111100000010000011111111000000000111100000000000000011111111100000000000000011111100011110011111
1111111110000011000011111111000000001111110000000000000001111111000000000000000000000000011110011111
1111111110000111100111111111100000011111111000000000000000011110000000000000000000000000001110011111
1111111100000111111111001111110000001111111000000000000000011111011000000000000000000000000000011111
1111100000000111111110001111111100000111111000000000000000011111111000011000000000010000000000111111
1111000000000011111110001111111100000111111000000000000000000111111100111000000000111001000000111111
1100000011000001111110000000111000000111111000000000000000000011111111111111100001111111100000011111
1100000111111000111111000000011000111111100000000000000000000001111111111111100001111111111000001111
1100000111111100011111000000000000011111000000100000000000000000111111111111100011111111111111001111
1110000001111110001111000010000000000111000111100000000000000000001111111111110011111111111111001111
1111000000111110001111001111000000000011000111100011100000000000000000011111110000011111111111001111
1111000000011111011111111111111100000011000111111111110001100000000000011111110000001111111111111111
1111000000011111111111111111111111110111000111111111111111110000111000011111100000011111111111111111
1111000000011111111111111111111111111111100011111111111111111001111000111111100000111111111111111111
1111111111111111111111111111111111111111110011111111111111111111111111111111111111111111111111111111
1111111111111111111111111111111111111111111111111111111111111111111111111111111111111111111111111111