
1111111111111111111111111111111111111111111111111111111111111111111111111111111111111111111111111111
1111111111111110001111111111111111111111111111111111111111111111111111111111111111100011110000011011
1111111111110000000111111111111111111111111111111111111111111111111100011111111111000011100000000011
1111111111110000000111111111111111111111111111110111111111111111111000001111111110000001000000000011
1111111111111000000011111111111111111111111111100011111100001111110000000111111100000000000000000011
1111111111111110000011111100111111111111111111100001111000001111100000000001111100000000000000000011
1111111111011110000011111110011111111111011111000000000001111111000110000001111100000000000000000011
1111111110011110000011111110001111111110011110000000000011111111000111111111111100000000000000000011
1111100000011110000001111110000001111110011100000000000001111111001111111111111100000000000000000111
1111000000111110000001111111000001111100000000000000000000111110011111111111111111000110000000000111
1000000000011110000000111111111001111000000000000000000000011000000111111111111111101110000000000111
1000000000011111000000011111111000000000000000000000000000000000000111110000000111111111110000000011
1100000000111111110000011111111100000000000010000000000000000011111111110000000000111111110000000001
1110000011111111111000011111111100000000011110000000000000000111111111111110000000111111100000000001
1110000111111111111000001111111100000000111110000000000001111111111111111111000000111111000000000001
1110000111111111110000000111111110000000111110000000000001111111111111100111000001111111000000000001
1110000110011111110000000000111110000001111110000000000001111111111111100111000001111111100000000011
1110000000001111110000000000011111011001111110000000000011111111001111110111100000111111111100000011
1111000000001111100000000000011111111111111110000000000111111111000111110011100000000111111100000111
1111000000001111000000000000111111111111111111000000001111111111100011110000000000000111111000000111
1110000000011110000000000000111100111111111111000000011111111111100011110000000000000001111111000111
1100000100011100000000000000000000011111111111000110111111111111100011110000000001100001111111000111
1100001100011110000000000000000000001111111111000111111111111111110011110000000011110001111100000111
1100011100000111000000000000000000000111111110001111111111111111110011110000000111110001110000000111
1111111100000111000000100000000001111111111110001111100011110111110011110000001111111000000000001111
1111111100001111000001110000000111111110011110001111000001100011100011111000011111111000000000000111
1111111001111111000011111000001111111110001110001111100000000001000111111100111111111000000000000011
1111110001111110000011111000011111111100001100000111110000000000000111111100111111111000000000000011
1111100001111100000011111100011111111100011100000011110000000111000111111000111011110000000011000011
1111000000111100000111111110011111111000111100000011110000001111100011110000000011110000000111100001
1110000000111110001111111111111111110000111000000011111000011111110011110000000011111000011111110011
1110011000011111001111111111111111110000011000000011111000011111110001100000001111111000111111111111
1111111100001111000011111110000111100000000000000000111000111111100000000000011111111000111111111111
1111111110000110000000011100000111000000000000000000111111111111100000000000111111111000001111111111
1111111111000000000000000000000000000000000000000000111111111111100110000000111111111000000111111111
1111111111000000000000000000000000000000000000000001111111111111101110000000011111111000000111111111
1111111111100000000000000000000000000000000000000001111111111111111100000000011111111111000001111111
1111111111110000000000000000000000000000000000000001111111111111111000011000111111111111100000111111
1111110001111000000000000000000011100100000000000001110111100001110000111111111111111111100000111111
1111110000111000000000000000000011111110000000000001100011100001110001111111111111111111000000110011
1111100110000000000000000000000011111110000010000000000011110001100011111111101111111111000000100011
1111000111000000000000000000000111111111000110000000000001110000000011111100000111111111000000000011
1111000111101100000000000000001111111111111110000000000000000000000000111000000111111111000000000011
1111000111111100000000000011111111111111111110000000000000000000000000000001100111111111000000000011
1111000011111000000000000111111111111111110000000000000000000000000000000011110111111111000011000111
1110000011111000000100001111111111111111000000110000000000000010000000111111111111111110000111100111
1100000001110000001110001111111111111110000011110000000000000110000001111111111111111110000011111111
1100000000000000001111011111111111111100011111111000000000000110000011111111111111111111000011111111
1100000000000000011110011111111111111000001111111000000000000111000011111111111111111111000011111111
1110000000000000111100011111111111110000000011111000100000011111000001111111111111111111000011111111
1111000000000001111110111111111111100000000001111101110000111110000000111111111111111110000111111111
1111000001100011111111111111111111000000000001111111110000111100000000011111111110000000001111111111
1111100001110001111111111111111111000011000001111110000001111111110000011111111111000000011111111111
1111100011110001111111111111111111000011000011111100000001111111111000111111111111100000011111111111
1110000111110001100111111111111111000011111111111100000001111111111001111111111111100000001111111111
1100000111110000000011111111111111000111111111111100000011111101100001111111111111100000000111111111
1100000111111000000111111111111111000111111111111111100111111000000000001111111111110000000011111111
1100001111111111111111111111111111000000111111111111100111111000000000001111111111111110000011111111
1111111111111111111111111111111111100000111111111111111111111100000000011111111111111111000011111111
1111111111111111111111111111111111111111111111111111111111111111111111111111111111111111111111111111