
1111111111111111111111111111111111111111111111111111111111111111111111111111111111111111111111111111
1111111111100001111111111111111111111111111111111111111111111111111111111111111111111111111111111111
1111111111000000111111111111111111111111111111000111111111111001111111111111111111111111111111111111
1111111111000000111110011111111111111111111110000011111111110000111000001111111111111111111111111111
1111111111100000111100000001111111111111111110000011111111100000000000000111001111111111001111111111
1111111111100000011000000000111111110011111110000011111111000000000000000000000111111000000111111111
1111111111100000000000000000000000000011111110000001111111000000000000000000000111110000000111111111
1111111111100000000000000000000000000011111110000000111111000000000000000000001111110000000111111111
1111111111110000000000110000000000000011111100000000011111000000000000011000011111110000001111111111
1111111111111000000001111000000000000001111100000000001111100000000000111100011111110000011111111111
1111111111111000000011111100000000000000111110000000000111100001111001111100011111110000011111111111
1111111111110000000011111110011001110000011111111111000111100011111111111100001111111000001111111111
1111111111100000000001111111111111111000011111111111100011100011111111111110000011111110000110011111
1111111111000000000001111111111111111000011111111111100000100011111111111111000001111111000000001111
1111111111000000000001111111111100110000011111111111100000000011111111111111100001111111000000001111
1111111110000000000001111111111000000000011111111111110000000001111111111111110011111111100000001111
1111111100000000000001111111111000000000001111111111111100000000111111111111111111111111111000001111
1111111000000000000001111111111100000011000111000111111110000000111111111111111111111111111110001111
1111111000000000000001111111111111111111000110000011111110000000011111111111111111111111111111000111
1111111100000000000000111111111111111111100000000001111111000000000000011111111111111111111111100111
1111111110000000000000011111111111111111110000000001111111100000000000000001111111111111111111000011
1111111110000000000000011111111111111111111000000001111111110000000000000000111111100110001110000011
1111111110000000000000011111111111111111111000000001111111110000000000000000011111000000000100000111
1111111110000000000000111111111111111111111000000001111111110001100000000000011111000000000000111111
1111111100000000000000111111111111111111110000000011111111100011110000000000011111100000000000111111
1111111100000000000001111111111111111111110000000111111111000011111000000000011111100000000000011111
1111111000000000000001111111111111111111111000001111111111000001111111111000001111000000000000001111
1111110000000000000011111111111111111111111000011111111111000000011111111110000110000000000000000111
1111110000001111001111111111111111111111111100111111111111100000001111111111000000000000000000000011
1111111000011110001111111111111111111111111111111111111111110000001111111111110000000000111000000011
1111111100111110001111111111111111111111111111111110000111110000011111111111111000000011111100000001
1111111111111110001111111111111111111111111111111100000011100000111111111111111000011111111110000001
1111111111111110001100001111111111111111111111111000000000000001111111100001111001111111111110000001
1111111111111110000000000111111111111111111111110000000000000001111111000000110011111111111100000001
1111111111111110000000000111111111111111111111100000000000000001111111000000000011111111111100000011
1111111111111110000000001111111111111111111111100000000000000011111111000000000011111111111100000011
1111111111111110000011111111111111111111111111110000000000000111111111100000000111100011111110000011
1111111111111110000111111111111111111111111111110000000000000111111111111100000111000001111110000111
1111111100011100001111111111111111111111111111100000011000001111111111111110001111000000001100001111
1111111000000000011111111111111111111111111111100000111110001111111111111111111111100000000000011111
1111111000000000011111111111111111111111111111100000111111000111111111111111111111110000000000011111
1111111000000000001111111111111111111111111111000001111111100011111111111111111111111000000000001111
1111111000000000001111111111111100111111000000000011111111110111111111111111111111111000000000000111
1111110000000000001111111111100000011110000000000011111111111111111111111111111111110000000000000111
1110000000000000000111111111000000001100000000000011111111111111111111111111111110000000000000000111
1100000000000000000011100110000000000000000011000001111111111111111111111111111000000000000000000111
1100000000000000000000000000000000000000000111100001111111111111111111111111100000000000000000000011
1100000000000000000000000000000000000000001111110001111111111111111111111100000000000000000000000011
1100000000000000000000000000000000000000011111111000111111111111111111000000001000000000000000000011
1100000000000000000000000000000000000000011111111000001111111111111110000000011111000000000000000001
1100000001100000000000000000000000000000011111111000000111111111111110000011111111100000111100000001
1100000111110000000000000000000000000000001111111100000111111111111110000111111111110001111111000001
1110011111110000000111111000000000000000001111111110001111111111111100001111111111110011111111100001
1111111111100000001111111100000000000000001111111111111111111111111000011111111111100011111111110001
1111111111100000001111111100000000000000011111111111111111111111110000011111111111000011111111110011
1111111111100000011111111100000000000111111111111111111111111111100000011111111111000001111111111111
1111111111110011111111111110000000001111111111111111111111111111100000111111111110000000111111111111
1111111111111111111111111111100000011111111111111111111111111111110011111111111110000000111111111111
1111111111111111111111111111110001111111111111111111111111111111111111111111111111000001111111111111
1111111111111111111111111111111111111111111111111111111111111111111111111111111111111111111111111111