
1111111111111111111111111111111111111111111111111111111111111111111111111111111111111111111111111111
1111111110011111111111001111111111111111111111111111111111111111111111111111111111111111111111111111
1111111100001111111110000111111111111111111111111111111111111111111111111111111111111111111111111111
1111111100000011111111000110011111111111111111111111111111111111101111111111111111111111111111111111
1111111000000001111111100000011111111111111111111111111111111111001111111111111111111111111111111111
1111110000110011111111100000011111111111111111111111111111111110001111111111111111101111111101111111
1111100001111111111111000000111111111111111111111111111111111100001111111111000011000111111000101111
1111100011111111111110000001111111111111111111111110011111111100001111111110000000000001111100000111
1111100011111111111110000011111111111111111100111100011111111110001111111110000000000001111100000011
1111100011111111111111100111111111111111111100011100011111111111001111111100000000000001111100000011
1111100011111111111111100000000110011111111110001100001111111100001111111111100000000001111100000011
1111100011111111111111100000000000011111111110001100000111111000001111111111100000000001111100000011
1111100011111111111111110000000000011111100000001100000011111000001111111111000000000011111000000011
1111110011111111111111111100001110011110000000001100000001111100011111111111000000000011111000000011
1110000001111111111111111100001110011110000110001100000001111100001111111111100000000111111000000011
1100000001111111111111111100011110000000000111111000000001111110000100011111110000000111111100000011
1100000000111100111111111000111110000000000011111000000001111111000000000111100000000111111100000111
1111110000111000000000110001111110000000000000111000000001111111110000000011000000000000000000001111
1111110000111000000000000001111110000000000000011000000011111111111000000000000000000000000000011111
1111100001111000100110000011111100000000110000000000000011111111110000000000000000000000011000111111
1111000011110001111111111111100000000001111000000000000011111111110000000000000000000000111111111111
1110000011110011111111111111100000000011111100000000000011111111100000000000000000000000111111111111
1100000000110011111111111111111111111111111100000000000011111111000000000000000000000000111111111111
1000000000010011111111111111111111111111111000000000000000001110000000000001100000000000111111111111
1100000000000011111111111111111111111111111000000000000000000000000000000001111110000001111111111111
1100000000000011111111111111111111111111111000000000000000000000000000000000111111111111111111111111
1111111111100011111111111111111111111111111000000000000000000000000000000000001111111111111111111111
1111111111110011111111111111111111111111111100000000000000001000001000000000001111111110011111111111
1111111111110011111111111111111111111111111110000001100000011111111111111000001111011110001111100111
1111110011110011111011111111111111111111111110000111100000011111111111111000001110001100001111000011
1111100001111111100011111111111111111111111100011111100000011111111111111000001100000000011110000011
1111100000111111000011111111111100011100000000111111110000001111111111110000011100000001111100000111
1100000000011111000011111111111000001000000001100000111000000111111111110001111100000001111000000111
1100000100000111000000111111111100000000000000000000011100000111111111110001111000000001110000001111
1100001110000111000000000011111100000000110000000000011100111111111111110001110000000011111000011111
1110011111000111000000000000001000000001111000000000011001111111111111100000000000001111111100011111
1111111111000111100000000000000001100001111110000000011111111111111111110000000000111111111100001111
1111111111000011110000001110001011100001111111110000011111111111111111111000000111111111111100000011
1111111110000000111111111111111111100011111111111000011111111111111111111110001111111101111111100011
1111111000000000001111111111111111100011111111111100011111111111111111111111000111000000111111100011
1111110000000000000111111111111111000111111111111110011111111111111111111111100010000000111111000011
1111100000000000000001111111111000001111111111111110011111111111100011111111100000000000110010000011
1111000000000000000000111111111000011111111111000110001111111111000011111111000000000000000000000011
1111000000110000000000011111110000011111111110000110000111111100000001111110000000000000000000000001
1111000000110000000000001111100000001111111111000110000111111000000001111111100000000000000000000001
1111100000110000111100000111000000000001111111000111000111110000000111111111110000000000000000000011
1111110000111001111110000000000000000001111111000111111111110000001111111111111000000000000000000011
1111110000111111111110000000000000000001111110001111111111110000001111111111111000000000000000000011
1111110000111111111110011000000000000000001100011111111111110000001111111111111000000000110000000011
1111000000111111111110011100000000000000000000111111111111110000000111111111110000000001111000000011
1110000000011111111100011100000000011111100000011111111111110000000111110111100000000011111000000011
1100000000011111110000011000000001111111110000001111111111111000000111100111100000000111110000000001
1100000000001111110000000000000011111111111110000011111111111000000000000011110000001111110000011011
1100000000001111110000000000000011111111111111000001111111111100000000000001100000001111111111111111
1110000111111111110000000000000001111111111111110000011111111110000000000000000000000111111111111111
1111001111111000110000000000000000111111111111111000001111111111000000000000000010000011111111111111
1111111111110000000000000000000111111111111111111100001111111111000000000011000110000011111111111111
1111111111111000000000000100001111111111111111111111111111111111011111000111111110001111111111111111
1111111111111111110001111111111111111111111111111111111111111111111111111111111111011111111111111111
1111111111111111111111111111111111111111111111111111111111111111111111111111111111111111111111111111