
1111111111111111111111111111111111111111111111111111111111111111111111111111111111111111111111111111
1111111111111111111111111111111111111111110001111111111111111111111111111111111111000011000111111111
1111111111000111111111111111111111111111100000111111111111111111111111111111111000000000000011111111
1111111110000011111111111111111111111111100000111110000111100111111111111111100000000000000011111111
1111111000000011111111111111111111111111100000011000000011000011111111111111000000000000000011111111
1111110000000111111111100111111111111111110000000000000000000001111111111111000000000000000001111111
1111110000000111111111000011111111111111111000000000000000000000111111111111100000000000000000000111
1111111000000111111111000000011111111111111000000000000000000000111111111111110000000000000000000011
1111111000000111111110000000000111111111111000000000000000000000111111111111111000000000000000000011
1111111000000011111110000000000011111111111000011000000000000001111111111111111000000000000000000011
1111110000000001111110000000000011111111111100111100000000000001111111111111111000000000000000000111
1111100000000000111110000000000111111001111111111100000000000011111111111111111000000000000000000111
1110000000000000011110000000000111110000011111111110000111111111111111111111111000000011111100000011
1100000000000000011110000000000111100000001111111110001111111111111111111111111000000111111110000001
1100000000000000111111000000000111100000001111111110001111111111111111111111110000000111111110000001
1000000000000000111111000110000111110000001111111100001111111100011111001111100000001111111110000011
1000011000000000111111001111001111110000001111111000011111111000001110000111100000011111111111000111
1100111100000000111111001111111111110000001111111000111111110000000000000111110000111111111111111111
1111111000100000111110000111111111100000001111110001111111110000000000000111110000111111111111111111
1111111000110001111110000011111111100000001111110001111111111000000000000111110000111111001111111111
1111111000111111111110000011111111110000001111110001111111111100000000000111110000111110000001111111
1111111000111111111110000011111111111000001111110000111111111100000000001111110000111110000000111111
1111110000111111111100000011111111111100001111110000000111111100000000001111111000111111000000111111
1111100000000001100000000111111111111100000111100000000011111000000000000111111000111111100000111111
1111000000000000000000011111111111111100000000000000000000000000000000000001111000011111110000011111
1110000000000000000000111111111111111100000000000000000000000000000000000000110000001111111000001111
1100000000000000000000111111111111111110000000000000000011000000000000000000000000001111111000000111
1100000000000000000000011111111111111111100000000000000111100000000000000000000000001111111000000111
1100000000000000000000001111111111111111100011000000000111111100000000011000000000011111000000000111
1000000000000000000000000111111111111111000111111100000111111110000000111100000000111110000000000011
1000000000000000000000000011111110000000001111111110001111111111000001111100000001111100000000000011
1000000000001100000000000001111100000000000111111111111111111111000001111100000001111000000000000011
1100011100111110000000000000111100000000000111111111111111111111000000111110000001111000000000000111
1111111111111110000000000000111110000011001111111111111111111110000000111111000001111000000110000111
1111111111111100000000001100011111000111111111111111100111111110000001111111100011110000001111000011
1111111111111000000000011110011110001111111111111111000011111100000001111111111111100000011111100001
1111111111111000000000011110011110001111111111111111000001110000000001111111111111000000111111100001
1111111111111000000000001100011100011111111111111110000000000000000001111111111111000001111111110011
1111111111111100000000000000000000011111111111111110000000000000000000111111111111100001111111111111
1111111111111111110000000000000000011111111111111111000000000000000000000111111111110000111111111111
1111111111111111111100000000000000001111111111111111000000000000000000000000001111110000111111111111
1111111110000001111110000000000000001111111111111111000000000000000011000000000111110000111111111111
1111111100000000000111000000000000011111111111111111000000000000000111100000000111110000111111111111
1111111100000000000011000000000000111111111111111111000000000000001111111110000111111000111111111111
1111111100000000000000000000000001111111111001111111100000000000011111111111000111111000011100111111
1111111100000000000000000000000001111111100000111111111100000000111111111111000011110000000000011111
1111111100000000000000000000000000111111000000111111111110000000111111111111000001100000000000001111
1111111100000000000000000000000000001110000000111111111110000000111111111110000000000000000000001111
1111111100000000000000000000000000000100000000111101111110000000111111111100000000000000000000011111
1111111100000000000000000000000000000000000000011000111110000001111111111000000000000000000000011111
1111111100011000000000000000000000000000000000000000111110000111111111000000000000000000011000011111
1111111100111100000000000000000000000000000000000001111100001111111110000000000110000001111100001111
1111111100111100000000000111001100000000000000000001111000001111111110000000001111000111111100000111
1111111101111100000000001111111110000000000000000001111000000111111110000000011111111111111100000111
1111111111111100000000001111111110000000000000000011111000000011111111001100111111111111111110001111
1111111111111110000000001111111110000000000000001111111100000001110011111111111111111111111111111111
1111111111111110000000011111111111000000000000011111111110000000000001111111111111111111111111111111
1111111111111111000000011111111111100001111000111111111111111000000001111111111111111111111111111111
1111111111111111111100111111111111110011111111111111111111111100110011111111111111111111111111111111
1111111111111111111111111111111111111111111111111111111111111111111111111111111111111111111111111111