
1111111111111111111111111111111111111111111111111111111111111111111111111111111111111111111111111111
1111111111111111111111111111111111111111111111111111111111111111111111111111111111111111111111111111
1110011000111111111111111111111111111111111111111111111111111111111111111111111111111111111111111111
1100000000011111111111111111111111111111111111111111111111111111111111111111111111111111111111111111
1100000000001111111111111111111111111111111111111111111111111111111111111111111111111111111111111111
1110000000000111111111111111111111111111110011111111111111111111111111111111111111111111111111111111
1111000011000000111111111111111100111111100001111111111111111111111111111111111111111111110001111111
1111100111100000011111111111111000011111000000111111111111111111111111111111111111111111100000011111
1111111111100000001111111111100000001110000000011111111111111111111111111111111111111111100000000111
1111111111000000000011111111000000000000000000000000011111111100111110000011111111111111110000000011
1111111100000000000001111111000000000000000000000000001111111000000000000001111111111111111110000011
1111111000000000000000111111100001100000000000000000001111110000000000000001111111111111111111000011
1111110000000000000000011111100011110000000000000000011111100000000000000001111111111111111111000011
1111100000000000000000011111110011111110000000000000111111100000000000000000111111111111111111000011
1110000000000000000000111111110001111111000000000000111111110000000000000000011111111111111111000111
1100000000000000000000111111110001111111000000000000111111111000000000000000000000000011111111000111
1100000000000000000000111111110011111110000000000000111111111000000000000000000000000001111110001111
1110011000000000000000111111100111111100000000000000011111110000000000000000000000000000000010001111
1111111111000000000000111111100111111000000000000000001111110000000011111100000000000000000000011111
1111111111100000000000011111001111111000000000000000011111100000000111111110000000000111000000001111
1111111111110000110000000000001111111000000000000111111111000000000111111110000000001111100000001111
1111111111111001111000000000001111111000000000011111111110000000001111111111001100001111100000011111
1111111111111111111100000000001111110000000000111111111100000000111111111111111110000111110000011111
1111111111111111111110000000011111100000000000111111111000000001111111111111111111000011110000001111
1111111111111111111111100001111111100000000000111111110000000011111111111111111111100011110000001111
1111111111111111111111110011111111100000000001111110000000000111111111110011111111100011111000011111
1111111111111111111111111111111111110000000001111100000000000111111111100000011111000001111111111111
1111111111111111111111111110001111111111000001111100000000000111111111000000001111000001111111111111
1111111111110011111111111100000111111111100001111110000000000111100000000000001111000001111111111111
1111111111000001111110000000000111111111100000111110000000000011000000000000011111100011111111111111
1111110000000000001100000000000111111111100000001100000000000000000000000000111111110111111111111111
1111100000000000000000000000000011111111100000000000000000000000000000000000111111111111111111100111
1111000000000000000000000000000001111111000000000001100000000000011100000000111111111111111111000011
1111000001111111100000000000000001111110000000000011110000000000111110000000011111111111111100000001
1111000011111111110000000000000001111110000000000011111000000001111111110000011111111111111000000001
1111000011111111110000000000000011111110000000000011111110000001111111111000111111111111111000000001
1111000011111111110000000000000111111110000000000011111111000001111111111111111111111111111100000011
1111100111111111110000000000000111111110000000000011111111100001111111111111111111111111111100000011
1111111111111111110000000000000011111110000000000011111111100001111111111111111111111111111000000011
1111111111111111110000111000000001111100000000000011111111100011111111111111111111111111111000000111
1111111111111111100001111100000000110000000000000111111111100011111111111111111111111111110000000111
1111111111111110000001111110000000000000000000001111000111100111001111111111111111111100000000001111
1111111111110000000011111111110000000000000000001110000011000110000111111111111111111000000000001111
1111111111100000000111111111111000000000000000011110000000000110000011100000001111110000000000011111
1111111110000000001111111111111000001110000000111111000000000111000000000000000111110000000000011111
1111111100000001111111111111110000011111000000111111100000000111100000000000000011111000000000011111
1111111000000011111111111111000000011111110000111111110000001111100000000000000001111000000000001111
1111100000000111111111000010000000011111111000111111110000001111100000000000000001111000000000000111
1111000000000111111110000000000000001111111000111111100000001111100000111111000011110000000000000011
1111000000000111111100000000111000000111110000111111100000011111100001111111100011110000000000000001
1111000000000111110000000001111100000111110000111111110000011111000011111111100001100000000000000001
1111100000001111100000000001111110000011110000111111110000011110000111111111000000000000000000000001
1111111110011111100000000000111111000001111000111111110000001100001111111110000000001110000000000001
1111111111111111111110000000011111100001111000111111100000000000011111111110000000011111110000000001
1111111111111111111111000000011111110011111000011111000000000000011111111110000000011111111001110011
1111111111111111111111100000011111111111111000011110000000000000001111111111000000011111111111111111
1111111111111111111111100000111111111111111000011110000000001100001111111111111000001111111111111111
1111111111111111111111100001111111111111111100111111001100011110011111111111111100001111111111111111
1111111111111111111111110011111111111111111111111111111111111111111111111111111110011111111111111111
1111111111111111111111111111111111111111111111111111111111111111111111111111111111111111111111111111